000000000000
000010000000
000010100000
000010000000
000000000000
000000001100
000000001100
000000000000
